20
12
01234567890123456789
--------#-----------
--------#-----------
--------#######-----
---------_C-_--_----
####----#######-----
--------#-----#-----
----#####--#--#-----
-----------#--#CCCCC
############--#-----
--------------#-----
--------------#-----
--------------#-----
 
p1,11,0
p2,9,10
jittery,16,0
self-confident,5,2
angry,5,3
happy,12,8
calm,16,9
calm,2,10

stone,8,3
 
mine,3,5,3,7
mine,0,7,10,7

