20
12
01234567890123456789
----------#----#----
----------#----#----
----------#----#----
----------#----#----
---------------#----
---------------#----
#####N##########----
---------------#----
---------------#----
--------------------
--------------------
--------------------
 
p1,0,3
p2,19,11

angry,2,8
sad,12,3

stone,10,4
stone,10,5