20
12
01234567890123456789
----------------#---
----------------#---
----------------#---
----------------#---
----------------#---
----------------#---
####--###########---
--------------------
--------------------
--------------------
--------------------
--------------------
 
p1,0,3
p2,0,9

angry,15,4

stone,4,6
stone,5,6