20
12
01234567890123456789
--------------------
####################
---CCCCCCCCCCCCCC---
--#################-
--#-----------------
--#---#####---------
--#---#---Z---------
--#---#---#---------
--#---#######-------
--#---------#####---
--#-----------------
--#-----------------
 
p1,0,3
p2,18,11

angry,1,10
sad,4,9
jittery,7,7

stone,17,2