20
12
01234567890123456789
----#---#-#---------
--#-#---#_#-----#---
--#-#---#-#-----#---
--#-#---#-###-------
--#-#---#-CCCC------
###-#---#-##########
----#N#-#-#---------
-#--#N#---#---------
-#--#N#---#-###-----
-#--#N#---#---#-----
-#----#---###-#-----
-#----#-------#-----
 
p1,0,6
p2,19,2

happy,0,0
calm,6,2
sad,9,0
jittery,14,1
angry,16,7

stone,2,0
mine,7,7,9,7